10 8 8
0 0 1 1 1 0 0 1
1 0 1 1 1 0 1 1
1 0 0 0 1 0 0 1
1 0 1 0 1 1 1 1
0 0 1 0 -1 1 0 0
0 1 1 1 1 1 1 1
0 0 0 1 1 1 0 0
1 1 1 1 1 1 1 1

0 1 1 1 1 1 1 1
0 0 0 1 0 0 0 0
0 1 0 1 1 1 1 0
0 1 0 0 0 -1 1 0
0 1 1 1 0 0 -1 1
0 1 1 0 1 1 1 1
0 0 0 0 1 1 1 1
0 1 1 1 1 1 1 1

0 0 0 1 1 1 1 1
1 1 0 0 0 1 1 1
0 0 0 1 0 0 0 -1
0 1 0 1 0 1 1 1
0 0 0 0 0 1 1 1
1 1 1 1 0 1 1 1
1 1 1 1 0 1 1 1
1 1 1 1 0 1 1 1

0 1 0 0 0 1 1 1
0 1 1 1 0 1 1 1
0 0 0 1 0 0 -1 0
1 1 0 1 0 1 1 1
1 1 0 0 0 1 1 1
1 1 1 1 0 1 1 1
1 1 1 1 0 1 1 1
1 1 1 1 0 1 1 1

0 0 0 0 0 1 1 1
1 1 1 1 0 1 1 1
0 0 0 0 0 1 0 0
0 1 1 1 1 1 1 0
0 0 0 0 0 1 1 0
1 1 1 1 0 1 0 1
-1 0 0 0 0 1 1 1
1 1 1 1 -1 1 0 0

0 0 1 0 0 0 1 1
1 0 1 0 1 0 1 1
0 0 1 0 0 0 1 -1
0 1 1 1 1 1 1 0
0 0 0 0 0 1 1 0
1 1 1 1 0 1 0 0
0 0 0 -1 0 1 1 1
1 1 1 1 0 0 0 1

0 1 0 0 0 0 0 0
0 1 1 0 0 1 0 0
0 0 0 1 1 0 0 0
1 1 0 1 1 0 0 0
0 1 0 0 0 1 0 0
0 0 1 1 -1 1 0 0
0 0 0 1 1 0 0 0
0 0 0 0 0 0 0 0

0 1 0 0 0 0 0 0
0 1 0 0 0 0 7 0
0 0 1 0 0 7 0 0
0 0 0 -1 0 1 0 0
0 0 0 7 0 1 0 0
0 0 7 0 0 7 0 0
0 7 0 0 0 0 7 0
0 0 0 0 0 1 -1 0

0 0 0 0 0 0 0 5
0 5 1 1 0 0 5 0
1 0 5 0 0 5 0 0
0 0 0 0 5 0 0 0
0 0 0 5 5 -1 0 0
0 0 5 0 0 5 0 0
0 0 0 0 0 0 0 0
5 0 0 0 0 0 0 5

0 0 1 1 1 1 1 1
1 0 0 0 0 0 0 1
1 0 1 1 1 1 0 1
1 0 1 -1 0 1 0 1
1 0 1 0 0 1 0 1
1 0 1 1 0 1 0 1
1 0 0 0 0 0 0 1
1 1 1 1 1 1 1 1